#number	block_area	block_id	move_type	pre_criterion	full_crit	expr_mean_crit	expr_mean_crit	expr_reg_crit	expr_kend_crit	expr_cor_crit	expr_euc_crit	expr_spear_crit	PPI_crit	feat_crit	TF_crit	percent_orig_genes	percent_orig_exp	exp_mean	trajectory_position	FEATURE_INDICES	move_class	num_genes	num_exps
1	180	21,22,23,24,25,26,27,28,29,30,31,32,33,34,35,36,37,38,39,40/21,23,25,26,27,33,34,39,40	e+	0.9919899763994152	0.9919899763994152	0.0	0.9946599606942411	0.9926272850144271	0.9886826834895772	0.0	0.0	0.0	0.0	0.0	0.0	1.0	0.0	1.4913360740211106	14		S_1	20	9	-1
2	160	21,22,23,24,25,26,27,28,29,30,31,32,33,34,35,36,37,38,39,40/24,28,29,30,31,32,36,37	e+	0.9895269620495588	0.9895269620495588	0.0	0.9944163399788961	0.9861532842904004	0.9880112618793797	0.0	0.0	0.0	0.0	0.0	0.0	1.0	0.0	1.13582473688925	13		S_1	20	8	-1
3	200	1,2,3,4,5,6,7,8,9,10,11,12,13,14,15,16,17,18,19,20/2,6,9,10,12,13,15,16,17,19	e-	0.9895237872556084	0.9895237872556084	0.0	0.9948562374796532	0.9845281469852095	0.9891869773019625	0.0	0.0	0.0	0.0	0.0	0.0	0.7142857142857143	0.0	0.9540591124813996	23		S_1	20	10	-1
4	140	41,42,43,44,45,46,47,48,49,50,51,52,53,54,55,56,57,58,59,60/42,43,44,45,47,49,52	g+	0.9867986661245718	0.9867986661245718	0.0	0.9941387526091888	0.9790782716168795	0.9871789741476472	0.0	0.0	0.0	0.0	0.0	0.0	0.0	0.5	0.9630175825822855	21		S_1	20	7	-1
5	266	41,42,43,44,46,47,48,49,50,52,53,54,55,56,57,58,59,60,147/10,41,44,46,48,51,53,56,57,59,60,78,82,145	g-	0.9798120426654457	0.9798120426654457	0.0	0.9885667832713394	0.9673790446251231	0.9834903000998747	0.0	0.0	0.0	0.0	0.0	0.0	0.75	0.16666666666666666	0.7745910504110776	47		S_1	19	14	-1
6	650	4,9,12,19,26,30,36,37,40,47,77,85,102,111,112,113,122,125,138,148,177,184,185,189,190,199/1,12,18,20,21,23,25,26,40,56,63,70,78,79,95,96,99,105,109,114,123,140,142,144,145	g-	0.9772797216070125	0.9772797216070125	0.0	0.9769268146423644	0.9746345400474207	0.9802778101312524	0.0	0.0	0.0	0.0	0.0	0.0	0.5	0.5263157894736842	0.8978653446318856	64		S_1	26	25	-1
7	810	30,35,42,46,48,49,50,56,60,67,83,88,89,92,101,106,112,117,134,141,153,157,169,177,191,196,200/5,7,15,18,20,35,36,42,43,45,52,59,60,63,69,82,89,90,99,115,125,126,127,128,130,131,140,146,147,150	g-	0.976315217760956	0.976315217760956	0.0	0.976397999307887	0.9734270059336245	0.9791206480413566	0.0	0.0	0.0	0.0	0.0	0.0	0.7368421052631579	0.6	0.8339254911039499	46		S_1	27	30	-1
8	504	41,43,44,46,47,49,50,54,56,57,59,84,86,103,120,125,132,148,159,180,184,190,192,199/23,25,29,31,32,35,43,44,45,47,49,71,74,92,115,116,123,138,142,143,148	g-	0.9758018808573136	0.9758018808573136	0.0	0.9761453165970146	0.9722877626729327	0.9789725633019934	0.0	0.0	0.0	0.0	0.0	0.0	0.7222222222222222	0.48	0.8638416832653742	39		S_1	24	21	-1
9	899	34,35,36,39,46,48,49,60,80,83,96,101,103,105,111,114,117,121,125,126,139,140,155,157,159,163,166,173,174,193,200/3,7,11,12,15,33,35,45,46,55,60,69,76,88,89,90,96,99,113,115,116,127,130,136,137,142,145,146,147	e+	0.9756266922265485	0.9756266922265485	0.0	0.9775300068091695	0.9697047927092323	0.9796452771612439	0.0	0.0	0.0	0.0	0.0	0.0	0.55	0.5	0.7973325772501031	65		S_1	31	29	-1
10	930	10,42,44,48,52,56,62,64,65,66,67,70,72,73,74,75,78,80,107,132,137,152,158,159,166,170,175,182,185,196,200/6,9,10,12,15,20,21,24,38,40,43,45,58,63,66,69,72,77,79,84,85,86,90,93,102,103,110,125,133,140	g+	0.9755698143465502	0.9755698143465502	0.0	0.9771121641176388	0.9701762497824248	0.9794210291395872	0.0	0.0	0.0	0.0	0.0	0.0	0.55	0.34782608695652173	0.8161324129744056	91		S_1	31	30	-1
11	725	5,31,43,44,45,55,56,58,62,86,96,101,104,106,112,117,125,141,144,155,172,174,177,191,192/5,7,11,12,16,20,26,43,44,45,47,51,54,67,71,82,87,97,98,107,108,109,114,115,125,126,136,137,138	g-	0.9753130793130156	0.9753130793130156	0.0	0.9752875731251779	0.9727428634063552	0.9779088014075139	0.0	0.0	0.0	0.0	0.0	0.0	0.55	0.7619047619047619	0.8664864821292881	51		S_1	25	29	-1
12	575	21,24,27,31,32,34,38,39,45,69,71,73,77,88,93,94,96,103,104,126,151,154,157,169,184/2,4,13,14,23,27,33,34,39,40,46,53,55,58,76,93,94,104,118,120,133,141,142	g-	0.9753118561750149	0.9753118561750149	0.0	0.9761319241015952	0.9725861733208798	0.9772174711025698	0.0	0.0	0.0	0.0	0.0	0.0	0.8947368421052632	0.6	0.8764706787567828	24		S_1	25	23	-1
13	660	2,4,7,8,10,12,14,15,18,19,20,26,28,61,68,71,72,75,77,78,95,115,131,133,143,167,169,170,173,180/1,4,11,18,19,20,24,31,37,46,49,53,60,63,70,71,79,92,107,108,134,148	g+	0.9751260211014934	0.9751260211014934	0.0	0.9761654986434718	0.9692838632073975	0.9799287014536108	0.0	0.0	0.0	0.0	0.0	0.0	0.6363636363636364	0.48	0.8220198884355359	56		S_1	30	22	-1
14	368	1,6,12,15,16,17,20,92,99,104,110,120,136,154,161,187/9,10,12,13,19,28,49,52,56,64,69,75,83,86,87,92,98,110,114,123,132,145,149	g-	0.974840196057334	0.974840196057334	0.0	0.9773075996012854	0.9684986470533612	0.9787143415173556	0.0	0.0	0.0	0.0	0.0	0.0	0.5555555555555556	0.3684210526315789	0.8899625766764021	47		S_1	16	23	-1
15	696	1,5,6,7,9,10,11,15,17,20,38,56,66,67,79,85,88,96,108,109,143,149,151,152,154,167,179,180,189/1,8,10,11,16,18,47,52,53,60,76,79,81,82,88,89,95,104,109,114,132,144,146,148	e+	0.9746707712240229	0.9746707712240229	0.0	0.9760937717519551	0.9693180417187506	0.9786005002013628	0.0	0.0	0.0	0.0	0.0	0.0	0.45	0.5789473684210527	0.8628163529338748	60		S_1	29	24	-1
16	672	4,6,12,17,28,29,30,37,63,69,83,84,96,97,106,114,120,127,138,157,159,169,173,174,177,189,191,194/7,10,12,14,15,16,21,23,34,42,57,63,72,86,91,98,113,115,121,125,132,146,147,149	g+	0.9745246031410896	0.9745246031410896	0.0	0.9764206000010742	0.9692164820939124	0.9779367273282819	0.0	0.0	0.0	0.0	0.0	0.0	0.6111111111111112	0.44	0.8115915674821723	67		S_1	28	24	-1
17	504	1,35,42,47,48,57,69,75,80,83,88,96,101,103,114,117,120,131,134,138,159,163,170,189/8,26,29,43,45,47,49,53,72,73,79,88,90,96,115,121,130,136,138,143,147	g-	0.9742724494409881	0.9742724494409881	0.0	0.9744584391800977	0.969260564846002	0.9790983442968647	0.0	0.0	0.0	0.0	0.0	0.0	0.42857142857142855	0.5333333333333333	0.8257557103904074	46		S_1	24	21	-1
18	598	2,4,13,14,43,64,66,69,72,74,78,80,84,95,97,102,133,153,160,173,176,177,185,189,191,194/11,20,23,27,28,29,30,43,49,50,56,63,71,74,83,111,115,118,127,131,132,137,146	g-	0.9741963805151467	0.9741963805151467	0.0	0.9765199920735187	0.9674743257591609	0.9785948237127604	0.0	0.0	0.0	0.0	0.0	0.0	0.5	0.4	0.8716670424675843	62		S_1	26	23	-1
19	209	12,21,22,23,24,28,36,46,48,49,50,51,60,82,88,89,106,142,179/19,23,27,34,40,59,75,82,100,126,147	g-	0.9741377479430918	0.9741377479430918	0.0	0.9712550970832544	0.9735227811433849	0.9776353656026366	0.0	0.0	0.0	0.0	0.0	0.0	0.9230769230769231	0.4444444444444444	0.9783824713440163	24		S_1	19	11	-1
