#number	block_area	block_id	move_type	pre_criterion	full_crit	expr_mean_crit	expr_mean_crit	expr_reg_crit	expr_kend_crit	expr_cor_crit	expr_euc_crit	expr_spear_crit	PPI_crit	feat_crit	TF_crit	percent_orig_genes	percent_orig_exp	exp_mean	trajectory_position	FEATURE_INDICES	move_class	num_genes	num_exps
1	375	26,27,28,29,30,31,32,33,34,35,36,37,38,39,40,41,42,43,44,45,46,47,48,49,50/27,28,29,30,31,34,37,40,41,43,44,45,46,47,49	e-	0.9938874201277134	0.9938874201277134	0.0	0.9967510731540121	0.9917096081453141	0.9932015790838138	0.0	0.0	0.0	0.0	0.0	0.0	0.9444444444444444	0.0	0.9940474339536668	48		S_1	25	15	-1
2	450	1,2,3,4,5,6,7,8,9,10,11,12,13,14,15,16,17,18,19,20,21,22,23,24,25/1,3,4,5,6,8,11,12,13,15,17,18,19,20,21,23,24,25	e+	0.9938803969858206	0.9938803969858206	0.0	0.9969585940316447	0.990953243910101	0.9937293530157165	0.0	0.0	0.0	0.0	0.0	0.0	0.7692307692307693	0.0	0.8951492381730002	27		S_1	25	18	-1
3	182	26,27,28,29,30,31,32,33,34,35,36,37,38,39,40,41,42,43,44,45,46,47,48,49,50,175/26,33,35,36,38,42,50	e+	0.9927570741439137	0.9927570741439137	0.0	0.9954987547293711	0.9926669995400104	0.9901054681623596	0.0	0.0	0.0	0.0	0.0	0.0	0.9444444444444444	0.0	1.5599636295712835	21		B_0	26	7	-1
4	325	101,102,103,104,105,106,107,108,109,110,111,112,113,114,115,116,117,118,119,120,121,122,123,124,125/102,103,104,105,108,109,110,111,115,116,117,122,125	e-	0.9923430574555866	0.9923430574555866	0.0	0.9964768211702981	0.9879192990968324	0.9926330520996294	0.0	0.0	0.0	0.0	0.0	0.0	0.13636363636363635	0.09523809523809523	0.8698942822964614	78		S_1	25	13	-1
5	250	101,102,103,104,105,106,107,108,109,110,111,112,113,114,115,116,117,118,119,120,121,122,123,124,125/107,112,113,114,118,119,120,121,123,124	e+	0.9916928374891932	0.9916928374891932	0.0	0.9961189786125783	0.9874407321502877	0.9915188017047138	0.0	0.0	0.0	0.0	0.0	0.0	0.8695652173913043	0.0	0.9739973846866004	26		S_1	25	10	-1
6	300	76,77,78,79,80,81,82,83,84,85,86,87,88,89,90,91,92,93,94,95,96,97,98,99,100/76,83,84,85,87,89,92,93,96,97,99,100	e-	0.990894833539226	0.990894833539226	0.0	0.9962999399298589	0.9841076668925112	0.9922768937953077	0.0	0.0	0.0	0.0	0.0	0.0	0.0	0.391304347826087	0.83127299548775	26		S_1	25	12	-1
7	250	51,52,53,54,55,56,57,58,59,60,61,62,63,64,65,66,67,68,69,70,71,72,73,74,75/56,58,59,62,63,66,67,69,71,74	e+	0.9899516834850787	0.9899516834850787	0.0	0.9961189786125783	0.9822172701379439	0.9915188017047138	0.0	0.0	0.0	0.0	0.0	0.0	0.0	0.0	0.8150789541890002	33		S_1	25	10	-1
8	208	51,52,53,54,55,56,57,58,59,60,61,62,63,64,65,66,67,68,69,70,71,72,73,74,75,223/53,55,57,61,68,70,72,73	g-	0.9892971662739004	0.9892971662739004	0.0	0.9956628520018161	0.9815611037354677	0.9906675430844172	0.0	0.0	0.0	0.0	0.0	0.0	0.25	0.2	0.9376432376837259	42		S_1	26	8	-1
9	252	2,5,6,30,31,36,37,38,43,44,45,48,110,150,167,182,196,199,222,232,268/27,29,34,40,43,45,77,138,163,183,194,196	g-	0.9820171457777117	0.9820171457777117	0.0	0.9857831095497489	0.9776038959613393	0.982664431822047	0.0	0.0	0.0	0.0	0.0	0.0	0.8333333333333334	0.5833333333333334	0.9659939228642644	26		S_1	21	12	-1
10	792	1,13,26,28,29,31,35,38,40,43,47,50,53,75,114,131,134,152,165,167,168,179,189,203,206,214,221,222,235,245,254,259,299/7,14,24,26,32,33,35,36,42,50,52,55,61,84,91,95,102,118,120,128,136,168,180,187	g+	0.9805602688869469	0.9805602688869469	0.0	0.9807700957454757	0.9789060767989808	0.9820046341163841	0.0	0.0	0.0	0.0	0.0	0.0	0.6842105263157895	0.5	0.8809254460724788	51		S_1	33	24	-1
11	600	5,6,8,9,11,15,20,24,37,41,46,52,57,61,63,66,74,77,110,127,191,197,206,231,242,262,279,282,290,292/1,8,13,18,21,23,25,34,46,50,58,59,63,121,125,154,162,164,189,191	g-	0.980368943912175	0.980368943912175	0.0	0.9804868517093056	0.9769699983062565	0.983649981720963	0.0	0.0	0.0	0.0	0.0	0.0	0.5	0.25	0.8988399391782127	71		S_1	30	20	-1
12	600	26,52,54,57,59,60,63,64,66,68,69,70,71,72,74,75,77,90,133,145,148,171,193,201,205,239,264,272,285,286/10,30,32,41,46,53,60,63,68,73,82,84,94,116,120,134,151,169,172,186	g-	0.9802914137207871	0.9802914137207871	0.0	0.9842798780841264	0.9736131844968167	0.982981178581418	0.0	0.0	0.0	0.0	0.0	0.0	0.6	0.4166666666666667	0.8922888879713342	46		S_1	30	20	-1
13	868	2,7,41,45,85,88,99,101,106,109,110,112,113,117,120,123,124,135,150,177,182,184,200,221,222,232,239,268/2,3,19,23,26,27,29,43,45,53,57,59,77,83,105,107,113,114,115,117,144,146,150,151,164,177,178,183,185,194,200	g+	0.9800899448386494	0.9800899448386494	0.0	0.9816304918670499	0.9764332180310861	0.9822061246178122	0.0	0.0	0.0	0.0	0.0	0.0	0.5714285714285714	0.52	0.8325924546019505	62		S_1	28	31	-1
14	616	16,23,55,59,65,67,71,74,75,91,101,107,109,140,174,182,188,192,214,228,235,237,246,251,262,272,289,294/7,10,24,42,48,53,73,76,77,78,94,98,115,122,130,135,141,147,161,168,176,188	g-	0.9795966375449044	0.9795966375449044	0.0	0.979484743710057	0.976196017024786	0.9831091518998705	0.0	0.0	0.0	0.0	0.0	0.0	0.5833333333333334	0.6666666666666666	0.8898177184970033	52		S_1	28	22	-1
15	713	5,8,11,54,63,72,75,78,90,94,100,111,112,119,133,148,162,168,169,171,172,193,203,220,242,262,263,285,290,292,296/7,13,19,20,26,28,34,35,39,41,43,44,46,49,50,54,63,99,116,146,149,159,162	g-	0.9792379570839884	0.9792379570839884	0.0	0.9811437778419075	0.9749778577588963	0.9815922356511613	0.0	0.0	0.0	0.0	0.0	0.0	0.6363636363636364	0.5	0.8694006357436475	53		S_1	31	23	-1
16	600	20,21,33,42,57,76,81,82,83,86,88,89,90,91,96,147,151,158,172,187,227,245,272,293,298/2,9,14,20,31,33,36,37,82,83,84,85,89,104,113,121,123,137,142,148,165,189,192,193	g+	0.9787070691819376	0.9787070691819376	0.0	0.9807921134418459	0.9726273288172214	0.9827017652867455	0.0	0.0	0.0	0.0	0.0	0.0	0.8	0.5555555555555556	0.8557589894994737	46		S_1	25	24	-1
