#number	block_area	block_id	move_type	pre_criterion	full_crit	expr_mean_crit	expr_mean_crit	expr_reg_crit	expr_kend_crit	expr_cor_crit	expr_euc_crit	expr_spear_crit	PPI_crit	feat_crit	TF_crit	percent_orig_genes	percent_orig_exp	exp_mean	trajectory_position	FEATURE_INDICES	move_class	num_genes	num_exps
1	160	41,42,43,44,45,46,47,48,49,50,51,52,53,54,55,56,57,58,59,60/43,44,48,49,53,56,58,59	e+	0.9898452306247839	0.9898452306247839	0.0	0.9945544863800683	0.9869494175316287	0.9880317879626546	0.0	0.0	0.0	0.0	0.0	0.0	0.8888888888888888	0.0	1.1397304374047503	20		B_0	20	8	-1
2	140	1,2,3,4,5,6,7,8,9,10,11,12,13,14,15,16,17,18,19,20/1,7,10,14,17,18,20	e+	0.989682382646557	0.989682382646557	0.0	0.994283145879014	0.9875458133219612	0.9872181887386958	0.0	0.0	0.0	0.0	0.0	0.0	0.0	0.18181818181818182	1.2738794686758572	29		S_1	20	7	-1
3	180	1,2,3,4,5,6,7,8,9,10,11,12,13,14,15,16,17,18,19,20/2,3,5,11,12,13,15,16,19	e+	0.9892374719208034	0.9892374719208034	0.0	0.9947672861469656	0.9842504382759354	0.9886946913395088	0.0	0.0	0.0	0.0	0.0	0.0	0.95	1.0	0.9734808377864447	4		S_1	20	9	-1
4	200	21,22,23,24,25,26,27,28,29,30,31,32,33,34,35,36,37,38,39,40/23,25,26,29,33,34,35,37,39,40	e-	0.9886918481085	0.9886918481085	0.0	0.9949950370346858	0.9818196396351246	0.9892608676556892	0.0	0.0	0.0	0.0	0.0	0.0	0.8888888888888888	0.0	0.8580875168606997	50		S_1	20	10	-1
5	180	61,62,63,64,65,66,67,68,69,70,71,72,73,74,75,76,77,78,79,80/61,62,68,69,70,71,73,75,77	g+	0.9884299650907432	0.9884299650907432	0.0	0.9947672861469656	0.9818279177857551	0.9886946913395088	0.0	0.0	0.0	0.0	0.0	0.0	0.4583333333333333	0.5	0.9380085645246666	13		S_1	20	9	-1
6	140	21,22,23,24,25,26,27,28,29,30,31,32,33,34,35,36,37,38,39,40/21,22,27,28,31,32,36	g-	0.9881455745018485	0.9881455745018485	0.0	0.994283145879014	0.9829353888878354	0.9872181887386958	0.0	0.0	0.0	0.0	0.0	0.0	0.0	0.3333333333333333	1.0940562958525712	27		S_1	20	7	-1
7	176	36,41,42,43,44,45,46,47,48,49,50,51,52,53,54,55,56,57,58,59,60,135/42,45,47,50,52,54,55,60	g+	0.9803550961456601	0.9803550961456601	0.0	0.9933770350391579	0.9595788768076255	0.9881093765901966	0.0	0.0	0.0	0.0	0.0	0.0	0.9444444444444444	0.8	0.6662588855827178	5		S_1	22	8	-1
8	957	1,3,4,6,9,10,13,14,16,19,20,21,22,23,24,25,26,27,29,30,36,44,63,65,69,73,76,78,121,163,168,172,173/1,5,7,14,17,18,19,20,21,22,27,32,36,41,44,45,52,61,69,73,75,77,90,103,135,141,143,144,146	g-	0.9798431429139548	0.9798431429139548	0.0	0.981476322296425	0.9750639572911642	0.982989149154275	0.0	0.0	0.0	0.0	0.0	0.0	0.48	0.64	0.8800267370051926	69		S_1	33	29	-1
9	840	21,23,25,26,29,33,39,62,64,65,66,67,69,71,74,75,76,77,78,93,94,124,150,163,172,173,190,191/12,21,22,27,31,32,36,42,44,62,68,69,71,73,75,77,92,98,101,102,107,110,116,118,123,125,129,131,136,141	g-	0.9786340518161035	0.9786340518161035	0.0	0.9794298904462051	0.9740675273520722	0.9824047376500331	0.0	0.0	0.0	0.0	0.0	0.0	0.56	0.6666666666666666	0.8431675165335755	54		S_1	28	30	-1
10	756	1,17,19,46,52,53,61,62,68,74,79,82,93,100,109,117,121,132,134,138,143,145,155,168,178,179,183/1,5,14,17,18,20,21,22,33,34,53,60,69,71,73,75,76,98,99,100,105,107,108,129,137,143,144,145	e+	0.9778399259274009	0.9778399259274009	0.0	0.9779167340079078	0.9753521618330898	0.9802508819412048	0.0	0.0	0.0	0.0	0.0	0.0	0.5625	0.45454545454545453	0.8367250014338177	68		S_1	27	28	-1
11	552	4,13,22,24,33,36,39,44,46,47,52,53,54,59,90,132,134,144,152,171,178,179,183/1,14,17,21,32,39,44,45,46,47,48,50,58,59,63,69,81,82,98,104,105,114,129,146	g-	0.9770870625290042	0.9770870625290042	0.0	0.9812289991489156	0.970302280955258	0.9797299074828392	0.0	0.0	0.0	0.0	0.0	0.0	0.9090909090909091	0.5	0.8910045171457669	36		S_1	23	24	-1
12	567	3,6,7,9,10,17,18,20,21,23,25,26,27,28,35,39,40,92,108,109,129,137,157,165,171,178,182/1,7,8,10,17,26,33,37,39,40,49,55,62,64,79,87,88,96,109,123,144	g-	0.9756997413560994	0.9756997413560994	0.0	0.9767101352487382	0.9705510657237181	0.9798380230958422	0.0	0.0	0.0	0.0	0.0	0.0	0.6666666666666666	0.375	0.8839578524133167	59		S_1	27	21	-1
13	464	22,23,27,62,64,69,70,71,74,75,78,94,141,155,172,179/5,6,7,18,22,26,28,32,34,38,41,42,44,54,58,65,69,70,71,73,75,77,94,102,125,129,134,138,143	e+	0.9755781588419644	0.9755781588419644	0.0	0.9768201355202679	0.9729708622185931	0.9769434787870324	0.0	0.0	0.0	0.0	0.0	0.0	0.4444444444444444	0.75	0.8556150017386074	42		S_1	16	29	-1
14	575	1,3,8,14,17,19,25,26,46,61,63,69,70,72,73,85,93,122,123,132,150,159,168,175,197/1,10,14,17,18,20,22,29,33,41,45,55,60,61,62,67,82,93,98,105,119,143,145	g+	0.9755630840879159	0.9755630840879159	0.0	0.9732300236082055	0.9758406380072514	0.9776185906482909	0.0	0.0	0.0	0.0	0.0	0.0	0.7368421052631579	0.6363636363636364	0.8424720809948019	34		S_1	25	23	-1
15	784	22,28,42,43,61,63,64,67,68,69,70,71,74,75,76,78,79,80,91,95,96,100,114,127,136,154,163,193/2,3,12,17,19,30,35,39,49,55,63,65,67,71,72,74,75,76,77,79,87,88,92,96,111,119,121,122	g-	0.9753140551768542	0.9753140551768542	0.0	0.9771821552358964	0.9690644744191802	0.9796955358754861	0.0	0.0	0.0	0.0	0.0	0.0	0.6666666666666666	0.5625	0.8155319192734716	59		S_1	28	28	-1
16	1020	2,22,23,25,26,28,29,30,32,36,37,38,40,52,57,59,93,98,105,109,115,135,148,149,170,176,180,181,183,187/2,5,6,21,22,25,27,29,31,32,36,46,51,52,56,58,65,74,78,82,83,90,91,100,101,102,106,116,117,130,131,144,147,148	g+	0.9746913385791061	0.9746913385791061	0.0	0.9768259529957186	0.9704476084670083	0.9768004542745911	0.0	0.0	0.0	0.0	0.0	0.0	0.5454545454545454	0.56	0.838487321319774	60		S_1	30	34	-1
17	464	23,25,40,62,65,69,72,74,75,76,78,79,82,92,94,97,114,116,139,145,150,163,168,170,172,173,179,180,192/5,6,27,34,38,41,43,69,70,73,75,83,94,120,123,143	g-	0.9746749443510504	0.9746749443510504	0.0	0.9772798540838352	0.9670561215884916	0.9796888573808245	0.0	0.0	0.0	0.0	0.0	0.0	0.6	0.25	0.9031631181838654	48		S_1	29	16	-1
18	462	5,6,7,9,13,24,28,29,39,40,64,67,79,80,81,98,103,113,126,131,132,140/3,13,16,25,26,29,33,38,39,46,53,56,71,76,85,112,125,128,131,132,135	g-	0.9743737310311555	0.9743737310311555	0.0	0.9769195824127932	0.966730573624315	0.9794710370563582	0.0	0.0	0.0	0.0	0.0	0.0	0.6	0.4117647058823529	0.822009794384511	49		S_1	22	21	-1
