#number	block_area	block_id	move_type	pre_criterion	full_crit	expr_mean_crit	expr_mean_crit	expr_reg_crit	expr_kend_crit	expr_cor_crit	expr_euc_crit	expr_spear_crit	PPI_crit	feat_crit	TF_crit	percent_orig_genes	percent_orig_exp	exp_mean	trajectory_position	FEATURE_INDICES	move_class	num_genes	num_exps
1	200	41,42,43,44,45,46,47,48,49,50,51,52,53,54,55,56,57,58,59,60/41,45,47,49,50,51,53,55,56,59	e+	0.9910893519297493	0.9910893519297493	0.0	0.9948138898718707	0.9894673761485502	0.9889867897688271	0.0	0.0	0.0	0.0	0.0	0.0	0.047619047619047616	0.05555555555555555	1.1331635076148	26		S_1	20	10	-1
2	140	61,62,63,64,65,66,67,68,69,70,71,72,73,74,75,76,77,78,79,80/63,67,68,72,76,78,80	e-	0.9886887246542365	0.9886887246542365	0.0	0.9940223407287782	0.9853309163596402	0.9867129168742914	0.0	0.0	0.0	0.0	0.0	0.0	0.2857142857142857	0.3	1.1781768113907143	19		S_1	20	7	-1
3	140	1,2,3,4,5,6,7,8,9,10,11,12,13,14,15,16,17,18,19,20/5,7,9,12,14,18,19	e-	0.9885121858792248	0.9885121858792248	0.0	0.9940223407287782	0.984801300034605	0.9867129168742914	0.0	0.0	0.0	0.0	0.0	0.0	0.25	0.0	1.1224580832795714	27		S_1	20	7	-1
4	231	41,42,43,44,45,46,47,48,49,50,51,52,53,54,55,56,57,58,59,60,161/42,43,44,46,48,50,52,54,57,58,60	g+	0.9864356775506047	0.9864356775506047	0.0	0.9943848105951483	0.9758475006910565	0.9890747213656093	0.0	0.0	0.0	0.0	0.0	0.0	0.3888888888888889	0.35294117647058826	0.8350668797013275	30		S_1	21	11	-1
5	160	61,62,63,64,65,66,67,68,69,70,71,72,73,74,75,76,77,78,79,80/62,66,69,70,71,73,75,77	e-	0.9849451084898814	0.9849451084898814	0.0	0.9943513656868512	0.9728619532619387	0.9876220065208545	0.0	0.0	0.0	0.0	0.0	0.0	0.7727272727272727	0.8888888888888888	0.8661030625222498	5		B_0	20	8	-1
6	280	13,21,22,23,24,25,26,27,28,29,30,31,32,33,34,35,36,37,38,39/21,22,25,26,27,28,29,30,32,33,37,40,89,96	e+	0.9822645890964967	0.9822645890964967	0.0	0.9907291636071727	0.9688970375370856	0.9871675661452319	0.0	0.0	0.0	0.0	0.0	0.0	0.52	0.1	0.7953063912420085	45		S_1	20	14	-1
7	441	1,2,3,4,5,6,7,8,10,11,12,13,14,15,16,17,18,19,20,36,45/1,2,3,4,6,7,8,10,11,13,15,16,17,46,65,68,79,89,131,140,148	e-	0.9801427520177479	0.9801427520177479	0.0	0.9844619613789789	0.9708403892406632	0.9851259054336016	0.0	0.0	0.0	0.0	0.0	0.0	0.8181818181818182	0.38095238095238093	0.6631127019866894	41		S_1	21	21	-1
8	493	8,49,51,56,60,61,62,63,68,69,73,75,76,78,79,80,91,104,107,123,128,130,147,151,158,172,179,181,186/25,26,33,39,45,47,53,55,63,76,80,88,123,131,135,137,139	g+	0.9776791165214513	0.9776791165214513	0.0	0.9784962665806876	0.9778284339733496	0.976712649010317	0.0	0.0	0.0	0.0	0.0	0.0	0.6521739130434783	0.47368421052631576	0.9944443366916222	39		S_1	29	17	-1
9	700	2,3,4,5,6,8,13,16,18,20,28,42,53,54,92,107,112,116,117,140,141,160,184,186,196/4,5,7,8,14,17,18,31,38,45,47,53,56,65,69,71,79,80,85,92,97,106,120,124,133,136,143,144	e+	0.9769912472291589	0.9769912472291589	0.0	0.9788648532176074	0.9717559064880672	0.9803529819818021	0.0	0.0	0.0	0.0	0.0	0.0	0.6153846153846154	0.6666666666666666	0.8924828296559342	49		S_1	25	28	-1
10	520	7,8,10,15,24,35,41,42,43,56,61,64,65,68,77,79,86,90,100,113,121,153,159,165,173,179/5,9,10,24,32,36,40,45,51,62,66,69,70,73,83,104,125,126,132,133	g+	0.9761641623485301	0.9761641623485301	0.0	0.9770860130860324	0.9706070410117434	0.9807994329478146	0.0	0.0	0.0	0.0	0.0	0.0	0.65	0.625	0.8719120381487914	50		S_1	26	20	-1
11	572	28,41,42,44,45,46,50,52,53,54,55,56,59,85,115,143,145,152,155,173,185,196/3,7,25,38,43,44,45,46,52,54,55,68,79,82,84,85,88,94,106,117,119,122,123,125,137,143	g-	0.9761612664522206	0.9761612664522206	0.0	0.9780304139112894	0.9746334879780084	0.9758198974673642	0.0	0.0	0.0	0.0	0.0	0.0	0.3	0.65	0.9358750456389356	46		S_1	22	26	-1
12	440	10,43,48,49,50,51,53,55,59,60,65,85,92,109,116,125,132,143,159,165,167,173/9,20,37,41,45,51,53,55,56,59,71,86,88,116,123,131,135,139,141,144	g+	0.9760174444547838	0.9760174444547838	0.0	0.9747623104852352	0.9759228939236293	0.9773671289554868	0.0	0.0	0.0	0.0	0.0	0.0	0.6	0.47368421052631576	0.9056795102057962	51		S_1	22	20	-1
13	1023	9,17,36,41,43,46,47,49,50,51,57,63,91,94,97,99,106,119,123,136,144,146,149,154,155,156,157,160,168,183,192/3,4,6,8,15,16,17,27,29,40,43,44,46,48,50,54,57,65,73,83,92,93,97,104,107,114,115,120,121,124,125,138,143	e+	0.9758757252584859	0.9758757252584859	0.0	0.9762466965766767	0.9725729633924612	0.9788075158063195	0.0	0.0	0.0	0.0	0.0	0.0	0.2777777777777778	0.34782608695652173	0.8053408373754946	90		S_1	31	33	-1
14	600	1,2,19,28,31,37,51,54,55,60,64,65,67,68,75,76,79,80,87,108,137,138,145,153/10,14,22,23,26,27,28,29,33,45,56,59,68,71,76,78,79,80,107,112,117,123,137,138,150	g-	0.9758419301238904	0.9758419301238904	0.0	0.9777174816853473	0.9729414095919876	0.9768668990943363	0.0	0.0	0.0	0.0	0.0	0.0	0.4166666666666667	0.4090909090909091	0.8748325998866623	62		S_1	24	25	-1
15	420	2,4,5,8,12,14,15,16,19,24,44,59,61,63,64,69,81,100,102,122,194/5,7,9,14,27,29,35,40,42,72,73,98,105,108,109,111,117,120,121,126	g+	0.9755761498368524	0.9755761498368524	0.0	0.9766506842179272	0.9715682734009685	0.9785094918916613	0.0	0.0	0.0	0.0	0.0	0.0	0.5294117647058824	0.6111111111111112	0.8826905548486944	42		S_1	21	20	-1
16	702	1,2,3,4,6,7,10,16,19,20,21,24,28,35,57,60,81,88,90,102,135,145,149,153,159,194/5,7,9,11,12,13,14,19,21,29,32,45,61,63,69,73,90,94,99,102,108,110,116,120,129,145,149	g+	0.9750682226408421	0.9750682226408421	0.0	0.9755479094976824	0.9739799863801673	0.9756767720446768	0.0	0.0	0.0	0.0	0.0	0.0	0.5833333333333334	0.5454545454545454	0.8034688711227445	66		S_1	26	27	-1
