#number	block_area	block_id	move_type	pre_criterion	full_crit	expr_mean_crit	expr_mean_crit	expr_reg_crit	expr_kend_crit	expr_cor_crit	expr_euc_crit	expr_spear_crit	PPI_crit	feat_crit	TF_crit	percent_orig_genes	percent_orig_exp	exp_mean	trajectory_position	FEATURE_INDICES	move_class	num_genes	num_exps
1	325	1,2,3,4,5,6,7,8,9,10,11,12,13,14,15,16,17,18,19,20,21,22,23,24,25/3,6,7,8,11,13,17,19,20,22,23,24,25	e-	0.9934487216880785	0.9934487216880785	0.0	0.9964396792566246	0.9913624027498731	0.9925440830577379	0.0	0.0	0.0	0.0	0.0	0.0	0.8	0.09523809523809523	1.0676529310133847	19		S_1	25	13	-1
2	250	26,27,28,29,30,31,32,33,34,35,36,37,38,39,40,41,42,43,44,45,46,47,48,49,50/26,29,35,42,43,46,47,48,49,50	g-	0.9929845250083812	0.9929845250083812	0.0	0.9960778088120203	0.9913413538996236	0.9915344123134999	0.0	0.0	0.0	0.0	0.0	0.0	0.1875	0.0	1.1811443413605003	32		S_1	25	10	-1
3	250	51,52,53,54,55,56,57,58,59,60,61,62,63,64,65,66,67,68,69,70,71,72,73,74,75/53,54,55,57,58,60,62,64,66,69	e-	0.9929335222652124	0.9929335222652124	0.0	0.9960778088120203	0.9911883456701169	0.9915344123134999	0.0	0.0	0.0	0.0	0.0	0.0	0.9230769230769231	0.21739130434782608	1.2013789093217004	18		S_1	25	10	-1
4	300	101,102,103,104,105,106,107,108,109,110,111,112,113,114,115,116,117,118,119,120,121,122,123,124,125/102,103,104,105,106,109,111,112,116,118,121,123	g+	0.9923708733499659	0.9923708733499659	0.0	0.9963234491232376	0.988523764542194	0.992265406384466	0.0	0.0	0.0	0.0	0.0	0.0	0.0625	0.21739130434782608	0.9737408713856663	31		S_1	25	12	-1
5	250	26,27,28,29,30,31,32,33,34,35,36,37,38,39,40,41,42,43,44,45,46,47,48,49,50/27,30,31,32,36,37,38,39,44,45	e+	0.9922252087745558	0.9922252087745558	0.0	0.9960778088120203	0.9890634051981471	0.9915344123134999	0.0	0.0	0.0	0.0	0.0	0.0	0.9230769230769231	0.21739130434782608	1.0852927813470001	14		S_1	25	10	-1
6	225	76,77,78,79,80,81,82,83,84,85,86,87,88,89,90,91,92,93,94,95,96,97,98,99,100/76,77,80,84,86,87,88,92,96	e+	0.9915493774266998	0.9915493774266998	0.0	0.9959197145651366	0.9876593766238183	0.9910690410911448	0.0	0.0	0.0	0.0	0.0	0.0	0.8333333333333334	1.0	1.0444198132029998	9		S_1	25	9	-1
7	250	76,77,78,79,80,81,82,83,84,85,86,87,88,89,90,91,92,93,94,95,96,97,98,99,100/78,81,82,85,89,90,93,95,98,100	e+	0.9909251416309021	0.9909251416309021	0.0	0.9960778088120203	0.985163203767186	0.9915344123134999	0.0	0.0	0.0	0.0	0.0	0.0	0.8333333333333334	0.0	0.9127563155902007	19		S_1	25	10	-1
8	264	51,52,53,54,55,56,57,58,59,60,61,62,63,64,65,66,67,68,70,71,72,73,74,75/51,52,63,65,67,68,70,71,72,73,75	g+	0.9902017549225522	0.9902017549225522	0.0	0.9960690526024827	0.9828981108846206	0.9916381012805533	0.0	0.0	0.0	0.0	0.0	0.0	1.0	1.0	0.8118064401359996	1		S_1	24	11	-1
9	275	101,102,103,104,105,106,107,108,109,110,111,112,113,114,115,116,117,118,119,120,121,122,123,124,125/101,107,110,113,114,115,117,119,122,124,125	g-	0.9884315020929927	0.9884315020929927	0.0	0.9961984866648039	0.9771933235341488	0.9919026960800251	0.0	0.0	0.0	0.0	0.0	0.0	1.0	0.7	0.7040436412947275	23		S_1	25	11	-1
10	1131	10,18,22,28,40,47,51,52,54,56,58,62,64,65,70,74,83,99,104,127,145,165,175,182,192,200,220,239,242,243,253,255,261,263,267,268,270,282,294/9,14,17,20,25,32,36,46,53,57,60,62,64,66,69,87,98,105,113,114,117,134,142,149,153,180,191,193,194	g-	0.9816246387767872	0.9816246387767872	0.0	0.982029293983782	0.979361188502242	0.9834834338443377	0.0	0.0	0.0	0.0	0.0	0.0	0.625	0.5454545454545454	0.9079997489134126	66		S_1	39	29	-1
11	868	7,9,16,26,27,30,31,34,38,41,43,45,49,52,58,60,115,155,170,210,223,233,234,239,250,258,261,298/8,14,15,20,30,31,32,34,36,37,40,44,45,52,56,57,64,68,69,82,83,89,90,98,106,118,126,129,132,134,152	e+	0.9816144590179894	0.9816144590179894	0.0	0.981826773785103	0.9802230981018482	0.9827935051670174	0.0	0.0	0.0	0.0	0.0	0.0	0.8571428571428571	0.36363636363636365	0.8487110082120038	66		S_1	28	31	-1
12	456	6,8,16,53,54,55,57,59,60,67,68,72,73,104,139,140,143,149,152,155,243,251,282,294/5,16,46,57,60,62,64,66,69,82,86,92,98,128,135,149,153,178,194	g+	0.9810729739775589	0.9810729739775589	0.0	0.9806047856512661	0.9783388580906283	0.9842752781907826	0.0	0.0	0.0	0.0	0.0	0.0	0.6666666666666666	0.5882352941176471	0.975764125527225	37		S_1	24	19	-1
13	550	22,26,28,29,31,32,36,40,44,48,49,56,58,66,71,73,99,106,128,182,200,260/2,5,6,17,26,28,31,32,38,40,41,45,47,54,64,66,67,74,77,105,108,118,137,166,196	g-	0.9809769102645255	0.9809769102645255	0.0	0.982548601940394	0.9770567224382591	0.9833254064149233	0.0	0.0	0.0	0.0	0.0	0.0	0.5	0.5	0.9389584565402521	57		S_1	22	25	-1
14	624	9,24,60,61,94,104,105,106,107,109,113,115,117,118,119,121,122,127,177,180,197,205,209,227,242,280/1,28,38,50,57,71,105,106,111,116,121,123,130,131,146,156,158,160,161,162,177,191,196,198	g+	0.980527441136366	0.980527441136366	0.0	0.98158387634563	0.9766973475257648	0.9833010995377034	0.0	0.0	0.0	0.0	0.0	0.0	0.6923076923076923	0.2222222222222222	0.9129281096371449	61		S_1	26	24	-1
15	357	1,2,3,4,5,6,7,8,9,10,13,15,16,18,19,20,21,22,23,24,140/1,2,4,5,9,10,12,14,15,16,18,20,21,35,39,128,174	g-	0.9805060948612518	0.9805060948612518	0.0	0.9852143559220363	0.9693611673881477	0.9869427612735715	0.0	0.0	0.0	0.0	0.0	0.0	0.8235294117647058	0.6875	0.5741610539340211	25		S_1	21	17	-1
16	532	26,38,48,53,54,57,58,59,62,64,66,67,68,69,75,149,160,193,210,217,219,236,237,247,248,270,278,299/16,46,53,57,60,62,66,69,74,80,98,153,155,162,166,174,187,191,194	g-	0.9803986351895762	0.9803986351895762	0.0	0.9815574053827263	0.9770545169434998	0.9825839832425026	0.0	0.0	0.0	0.0	0.0	0.0	0.8260869565217391	0.5882352941176471	0.8769070617690293	33		S_1	28	19	-1
17	728	3,26,27,30,31,38,43,45,47,49,52,62,63,89,144,177,190,191,200,207,236,250,264,277,290,293/3,15,28,31,32,38,39,45,48,52,56,57,58,61,71,78,82,88,113,127,129,136,145,152,181,189,191,196	e+	0.9795345999222637	0.9795345999222637	0.0	0.980155397568385	0.9756222895181031	0.9828261126803033	0.0	0.0	0.0	0.0	0.0	0.0	0.6666666666666666	0.4090909090909091	0.8520899187163098	72		S_1	26	28	-1
18	961	33,57,81,82,83,88,89,90,91,92,93,94,95,97,98,100,103,147,176,180,189,198,213,215,229,233,234,241,248,295,300/1,5,24,27,29,38,59,68,77,81,82,86,88,89,98,100,126,131,145,147,151,152,153,156,161,166,169,174,184,190,198	g-	0.9794808169391792	0.9794808169391792	0.0	0.9818291160847719	0.9740034770396386	0.9826098576931274	0.0	0.0	0.0	0.0	0.0	0.0	0.45	0.48	0.8589957959792497	71		S_1	31	31	-1
19	550	1,3,5,6,8,10,14,15,19,23,51,90,96,118,136,156,170,224,243,259,272,277,287,293,299/6,7,8,19,21,22,31,59,66,72,93,95,105,109,111,139,150,167,168,175,185,188	e+	0.9794425562821581	0.9794425562821581	0.0	0.9816905781623869	0.9749313251294147	0.981705765554673	0.0	0.0	0.0	0.0	0.0	0.0	0.6875	0.5238095238095238	0.9095808126120499	38		S_1	25	22	-1
20	1470	7,12,21,32,53,54,56,61,63,64,65,66,67,68,69,73,102,105,110,117,120,122,123,154,161,209,233,260,266,289/2,5,9,15,24,28,30,32,38,39,41,43,44,48,52,54,57,58,60,63,64,67,71,73,76,77,82,83,91,93,99,103,104,105,106,111,113,120,121,127,136,143,145,159,164,166,169,172,181	g-	0.9789229258260561	0.9789229258260561	0.0	0.9810780820560645	0.9733107301442765	0.9823799652778274	0.0	0.0	0.0	0.0	0.0	0.0	0.4117647058823529	0.5454545454545454	0.8187595803922441	84		S_1	30	49	-1
