#number	block_area	block_id	move_type	pre_criterion	full_crit	expr_mean_crit	expr_mean_crit	expr_reg_crit	expr_kend_crit	expr_cor_crit	expr_euc_crit	expr_spear_crit	PPI_crit	feat_crit	TF_crit	percent_orig_genes	percent_orig_exp	exp_mean	trajectory_position	FEATURE_INDICES	move_class	num_genes	num_exps
1	675	1,2,3,4,5,6,7,8,9,10,11,12,13,14,15,16,17,18,19,20,21,22,23,24,25,82,122/1,2,3,4,5,6,7,8,9,10,11,12,13,14,15,16,17,18,19,20,21,22,23,24,25	g+	0.9946684795441616	0.9946684795441616	0.0	0.0	0.0	0.0	0.9946684795441616	0.0	0.0	0.0	0.0	0.0	0.5217391304347826	0.8421052631578947	0.7835872378614391	15		S_1	27	25	-1
2	675	20,76,77,78,79,80,81,82,83,84,85,86,87,88,89,90,91,92,93,94,95,96,97,98,99,100,295/76,77,78,79,80,81,82,83,84,85,86,87,88,89,90,91,92,93,94,95,96,97,98,99,100	g+	0.994660035057999	0.994660035057999	0.0	0.0	0.0	0.0	0.994660035057999	0.0	0.0	0.0	0.0	0.0	0.0	0.7894736842105263	0.7208853191421042	16		S_1	27	25	-1
3	700	64,101,102,103,104,105,106,107,108,109,110,111,112,113,114,115,116,117,118,119,120,121,122,123,124,125,199,262/101,102,103,104,105,106,107,108,109,110,111,112,113,114,115,116,117,118,119,120,121,122,123,124,125	g-	0.9946097314020081	0.9946097314020081	0.0	0.0	0.0	0.0	0.9946097314020081	0.0	0.0	0.0	0.0	0.0	0.19047619047619047	0.56	0.7565705091355888	17		S_1	28	25	-1
4	625	51,52,53,54,55,56,57,58,59,60,61,62,63,64,65,66,67,68,69,70,71,72,73,74,75/51,52,53,54,55,56,57,58,59,60,61,62,63,64,65,66,67,68,69,70,71,72,73,74,75	g+	0.9945356822786076	0.9945356822786076	0.0	0.0	0.0	0.0	0.9945356822786076	0.0	0.0	0.0	0.0	0.0	0.2222222222222222	0.3157894736842105	0.8075121752441281	28		S_1	25	25	-1
5	600	26,27,28,29,30,31,32,33,34,35,36,37,38,39,40,41,42,44,45,46,47,48,49,50/26,27,28,29,30,31,32,33,34,35,36,37,38,39,40,41,42,43,44,45,46,47,48,49,50	g+	0.9944215159092293	0.9944215159092293	0.0	0.0	0.0	0.0	0.9944215159092293	0.0	0.0	0.0	0.0	0.0	0.2	0.5833333333333334	0.5026440941456001	16		S_1	24	25	-1
6	147	45,185,230/5,6,9,16,18,19,51,53,54,68,84,88,89,95,97,104,106,108,111,116,118,119,120,121,125,127,129,131,144,146,147,148,149,151,158,159,161,167,171,172,174,175,179,185,186,191,196,197,199	e-	0.99067709577198	0.99067709577198	0.0	0.0	0.0	0.0	0.99067709577198	0.0	0.0	0.0	0.0	0.0	0.0	0.6470588235294118	0.7641326229607924	57		S_1	3	49	-1
7	480	1,5,8,9,21,39,41,64,103,191,192,200,227,281,290/2,3,5,6,9,10,11,13,14,16,17,18,19,20,22,27,28,30,40,59,62,83,84,92,97,109,117,127,138,181,191,197	e+	0.9880258406370428	0.9880258406370428	0.0	0.0	0.0	0.0	0.9880258406370428	0.0	0.0	0.0	0.0	0.0	0.23076923076923078	0.4583333333333333	0.7739445837606086	52		S_1	15	32	-1
8	364	3,5,10,12,14,20,25,33,46,83,114,164,178/3,4,5,7,8,9,10,11,12,13,16,17,21,22,50,56,67,72,81,91,98,99,139,151,164,183,192,195	g-	0.9877419232539721	0.9877419232539721	0.0	0.0	0.0	0.0	0.9877419232539721	0.0	0.0	0.0	0.0	0.0	0.46153846153846156	0.8333333333333334	0.8543569793459542	28		S_1	13	28	-1
9	480	16,81,91,93,94,104,105,126,129,162,178,202,213,228,238/13,21,32,35,37,72,73,74,79,81,82,85,86,88,91,94,98,100,117,121,123,124,134,150,152,159,162,169,172,173,177,199	e+	0.9872421816921022	0.9872421816921022	0.0	0.0	0.0	0.0	0.9872421816921022	0.0	0.0	0.0	0.0	0.0	0.2	0.56	0.7851918820474899	57		S_1	15	32	-1
10	248	5,81,86,94,99,173,208,299/13,23,29,32,45,47,66,80,81,82,88,89,90,95,97,100,108,123,136,141,143,144,153,155,159,173,188,190,195,197,200	g-	0.986932621073418	0.986932621073418	0.0	0.0	0.0	0.0	0.986932621073418	0.0	0.0	0.0	0.0	0.0	0.3333333333333333	0.5263157894736842	0.785421112770125	48		S_1	8	31	-1
11	754	9,12,18,20,22,24,25,30,50,57,58,61,75,80,81,87,105,124,150,153,155,161,230,261,279,291/1,2,3,8,9,12,14,18,21,22,24,25,45,46,67,75,79,86,98,100,122,130,131,138,154,171,184,188,198	g-	0.9869303460151465	0.9869303460151465	0.0	0.0	0.0	0.0	0.9869303460151465	0.0	0.0	0.0	0.0	0.0	0.47619047619047616	0.68	0.786242253722501	45		S_1	26	29	-1
12	270	12,16,187,276,290,298/2,3,5,7,8,9,11,13,14,17,18,24,25,31,41,42,44,46,50,69,72,75,80,87,105,112,117,120,121,130,136,141,143,150,151,154,155,158,164,176,177,181,186,193,197	e+	0.9866816078025678	0.9866816078025678	0.0	0.0	0.0	0.0	0.9866816078025678	0.0	0.0	0.0	0.0	0.0	0.14285714285714285	0.7894736842105263	0.8756986417837275	29		S_1	6	45	-1
13	248	26,58,74,82,108,115,118,285/8,11,18,22,28,35,39,41,42,44,55,56,57,59,61,63,64,65,66,71,73,129,143,154,157,159,166,169,170,190,199	g-	0.9866187003118836	0.9866187003118836	0.0	0.0	0.0	0.0	0.9866187003118836	0.0	0.0	0.0	0.0	0.0	0.3333333333333333	0.7391304347826086	0.815791403389167	31		S_1	8	31	-1
14	279	36,38,99,110,141,246,255,275,287/20,27,31,36,43,47,51,73,80,83,84,85,90,100,109,111,113,118,122,127,130,131,132,139,146,167,171,183,193,196,200	g-	0.9865482792458734	0.9865482792458734	0.0	0.0	0.0	0.0	0.9865482792458734	0.0	0.0	0.0	0.0	0.0	0.1111111111111111	0.75	0.7951379683651026	39		S_1	9	31	-1
15	644	9,17,30,47,57,78,81,83,89,91,92,94,97,101,105,118,139,168,178,190,193,215,228,233,234,238,239,279/9,54,77,81,82,83,86,87,89,91,92,97,98,99,100,105,126,130,134,144,152,159,184	e+	0.986435903997714	0.986435903997714	0.0	0.0	0.0	0.0	0.986435903997714	0.0	0.0	0.0	0.0	0.0	0.5238095238095238	0.7142857142857143	0.8617543628224478	43		S_1	28	23	-1
16	216	3,14,16,18,28,51,81,96,228/2,3,11,14,18,19,21,23,25,49,67,85,88,91,92,93,94,101,131,141,150,155,158,180	g-	0.9857258712302739	0.9857258712302739	0.0	0.0	0.0	0.0	0.9857258712302739	0.0	0.0	0.0	0.0	0.0	0.17647058823529413	0.2631578947368421	0.749445034686657	27		S_1	9	24	-1
17	364	48,104,106,129,137,144,188,199,218,220,237,263,298/13,14,16,29,32,46,65,68,69,78,80,89,99,109,110,111,113,142,150,154,166,167,175,176,190,192,193,197	e+	0.9856267455716825	0.9856267455716825	0.0	0.0	0.0	0.0	0.9856267455716825	0.0	0.0	0.0	0.0	0.0	0.46153846153846156	0.84	0.7654444976517667	25		S_1	13	28	-1
18	570	26,27,28,31,35,36,41,45,49,58,59,61,68,88,134,137,187,244,294/26,27,28,30,33,35,36,37,38,43,45,49,50,51,53,56,59,60,61,64,66,68,72,76,118,152,153,168,177,183	g-	0.9854184875429435	0.9854184875429435	0.0	0.0	0.0	0.0	0.9854184875429435	0.0	0.0	0.0	0.0	0.0	0.5789473684210527	0.875	0.8098644155438214	24		S_1	19	30	-1
19	280	43,103,104,109,112,138,188,233,255,258/5,16,21,22,36,43,44,53,60,63,66,82,84,90,92,100,109,111,112,120,121,122,125,132,148,157,162,181	g-	0.9853299502275217	0.9853299502275217	0.0	0.0	0.0	0.0	0.9853299502275217	0.0	0.0	0.0	0.0	0.0	0.2222222222222222	0.782608695652174	0.8000385528207804	25		S_1	10	28	-1
