#number	block_area	block_id	move_type	pre_criterion	full_crit	expr_mean_crit	expr_mean_crit	expr_reg_crit	expr_kend_crit	expr_cor_crit	expr_euc_crit	expr_spear_crit	PPI_crit	feat_crit	TF_crit	percent_orig_genes	percent_orig_exp	exp_mean	trajectory_position	FEATURE_INDICES	move_class	num_genes	num_exps
1	200	41,42,43,44,45,46,47,48,49,50,51,52,53,54,55,56,57,58,59,60/44,46,47,48,50,52,57,58,59,60	e+	0.9907438741726601	0.9907438741726601	0.0	0.995048991083811	0.9877691903591931	0.9894134410749762	0.0	0.0	0.0	0.0	0.0	0.0	0.9411764705882353	0.0	1.0258341610580002	24		S_1	20	10	-1
2	240	61,62,63,64,65,66,67,68,69,70,71,72,73,74,75,76,77,78,79,80/61,62,63,67,68,69,72,73,75,76,78,80	e-	0.9900833132952284	0.9900833132952284	0.0	0.9953777405635824	0.984582977740859	0.9902892215812438	0.0	0.0	0.0	0.0	0.0	0.0	0.9166666666666666	0.47058823529411764	0.8761780713779166	14		S_1	20	12	-1
3	189	20,21,22,23,24,25,26,27,28,29,30,31,32,33,34,35,36,37,38,39,40/23,27,28,30,31,32,33,35,37	e+	0.9900165423185691	0.9900165423185691	0.0	0.9946831501531377	0.9861793367814086	0.9891871400211614	0.0	0.0	0.0	0.0	0.0	0.0	0.8421052631578947	0.0	1.0647962662288735	24		S_1	21	9	-1
4	105	1,2,3,4,5,6,7,8,9,10,11,12,13,14,15,16,17,18,19,20,52/1,6,9,12,16	e-	0.9873269170273745	0.9873269170273745	0.0	0.9934497767069479	0.9831994263328641	0.9853315480423117	0.0	0.0	0.0	0.0	0.0	0.0	0.6842105263157895	0.0	1.2339586289118094	21		S_1	21	5	-1
5	140	61,62,63,64,65,66,67,68,69,70,71,72,73,74,75,76,77,78,79,80/64,66,70,71,74,77,79	g-	0.9864751020830708	0.9864751020830708	0.0	0.9943166465634214	0.9778956583656211	0.9872130013201699	0.0	0.0	0.0	0.0	0.0	0.0	0.7619047619047619	0.4666666666666667	0.9568349097555713	11		B_0	20	7	-1
6	140	21,22,23,24,25,26,27,28,29,30,31,32,33,34,35,36,37,38,39,40/21,24,25,29,34,38,39	e+	0.9862189366235783	0.9862189366235783	0.0	0.9943166465634214	0.9771271619871436	0.9872130013201699	0.0	0.0	0.0	0.0	0.0	0.0	0.8421052631578947	0.5	0.981699479438429	12		S_1	20	7	-1
7	609	14,16,19,41,44,45,46,47,48,49,52,53,56,59,65,76,80,106,114,129,134,136,137,156,162,170,180,181,190/1,7,9,11,25,26,29,46,48,50,52,56,67,68,72,78,80,85,96,102,131	e+	0.9788548919114319	0.9788548919114319	0.0	0.9800197466807813	0.974185673922914	0.9823592551306005	0.0	0.0	0.0	0.0	0.0	0.0	0.3684210526315789	0.3888888888888889	0.8596775050521503	61		S_1	29	21	-1
8	546	1,10,14,31,49,70,72,80,82,87,95,103,110,114,124,134,136,142,143,157,172,177,181,184,196,199/1,6,12,23,25,39,41,44,45,46,53,58,61,72,76,86,89,92,96,121,129	g+	0.9759716049845243	0.9759716049845243	0.0	0.97944487650985	0.9677073425105446	0.9807625959331783	0.0	0.0	0.0	0.0	0.0	0.0	0.6666666666666666	0.3888888888888889	0.8482691085215882	54		S_1	26	21	-1
9	598	1,4,7,10,13,27,29,39,46,57,74,80,84,87,91,92,103,105,106,117,134,140,166/1,3,7,12,13,20,23,42,48,53,55,60,62,63,67,77,81,85,86,96,105,115,122,126,139,144	g-	0.9757486225188424	0.9757486225188424	0.0	0.9739156934247037	0.9753787178280598	0.9779514563037637	0.0	0.0	0.0	0.0	0.0	0.0	0.75	0.47368421052631576	0.8549988006210971	52		S_1	23	26	-1
10	700	2,7,12,13,14,16,17,19,35,41,54,59,62,64,65,91,97,105,107,119,132,146,152,158,168/4,5,7,8,10,16,24,42,43,45,48,50,64,70,73,77,84,85,88,93,100,104,125,127,129,136,140,141	e+	0.9757211629369801	0.9757211629369801	0.0	0.9777638186952837	0.9699754284640032	0.9794242416516535	0.0	0.0	0.0	0.0	0.0	0.0	0.8461538461538461	0.5	0.8117755271491783	54		S_1	25	28	-1
11	650	7,13,25,28,35,44,49,61,62,65,66,68,73,75,77,78,79,107,147,152,153,175,182,190,195/5,8,10,14,22,32,42,46,48,62,65,68,72,73,76,78,80,82,93,94,99,100,122,128,132,140	g-	0.9755202625129863	0.9755202625129863	0.0	0.9769038670692829	0.9705492933657125	0.9791076271039636	0.0	0.0	0.0	0.0	0.0	0.0	0.6875	0.5454545454545454	0.8738126444120653	47		S_1	25	26	-1
12	812	19,20,21,46,54,55,61,73,83,84,87,89,97,102,106,111,114,122,129,132,143,145,146,152,168,185,187,200/19,25,30,45,50,71,72,73,83,84,85,91,96,101,102,103,105,110,115,117,118,122,126,133,134,136,137,146,147	g+	0.9755042219431984	0.9755042219431984	0.0	0.976365307780681	0.9723160640014092	0.9778312940475051	0.0	0.0	0.0	0.0	0.0	0.0	0.6666666666666666	0.5833333333333334	0.8157562361046977	54		S_1	28	29	-1
13	700	5,12,14,24,29,30,32,36,38,64,79,91,105,114,131,136,140,142,164,167,176,178,181,185,199/1,12,15,21,23,29,30,48,51,60,64,66,72,85,92,93,94,101,105,108,114,115,120,127,130,135,137,138	e+	0.9754832784635834	0.9754832784635834	0.0	0.9775896441297589	0.970110449652386	0.9787497416086051	0.0	0.0	0.0	0.0	0.0	0.0	0.4666666666666667	0.55	0.8274122995311685	60		S_1	25	28	-1
14	725	3,31,36,41,43,44,46,48,50,51,52,55,57,58,59,66,94,98,127,140,141,146,158,163,168/5,11,14,17,18,34,36,37,38,43,46,47,48,52,58,67,74,80,85,91,94,99,109,110,123,124,127,131,144	g+	0.9754592604437095	0.9754592604437095	0.0	0.9780902379845544	0.968952658953069	0.9793348843935046	0.0	0.0	0.0	0.0	0.0	0.0	0.4	0.6666666666666666	0.8702844837373219	57		S_1	25	29	-1
15	598	6,7,9,16,45,46,49,52,56,57,63,67,73,100,110,113,116,119,126,127,145,159,171,180,187,195/5,6,12,13,15,20,34,37,41,58,60,66,78,80,86,93,98,101,109,125,135,140,144	g+	0.974842809528158	0.974842809528158	0.0	0.9777114325769187	0.9681131780038378	0.9787038180037174	0.0	0.0	0.0	0.0	0.0	0.0	0.6818181818181818	0.5789473684210527	0.8273228564653036	40		S_1	26	23	-1
16	672	5,6,9,13,14,16,35,44,46,47,53,56,57,62,77,106,113,118,119,126,127,145,151,156,160,180,184,187/1,5,8,13,15,20,23,34,55,57,60,64,66,67,78,98,103,107,109,115,116,121,125,144	e+	0.9746974756031849	0.9746974756031849	0.0	0.9780134783813437	0.9655512776626389	0.9805276707655719	0.0	0.0	0.0	0.0	0.0	0.0	0.6521739130434783	0.6842105263157895	0.8156365191085528	46		S_1	28	24	-1
17	380	9,14,41,42,44,45,46,47,49,50,52,53,56,57,59,76,161,169,196/1,17,24,41,42,43,44,49,51,54,55,56,57,69,78,85,96,113,130,138	e+	0.9744532433898182	0.9744532433898182	0.0	0.9776887315019873	0.965829035425376	0.9798419632420914	0.0	0.0	0.0	0.0	0.0	0.0	0.7647058823529411	0.9285714285714286	0.6607237415870558	25		S_1	19	20	-1
18	484	5,9,25,35,46,53,62,65,66,75,102,110,113,114,143,154,156,165,187,190,194,195/1,3,5,8,10,45,71,74,77,78,84,93,95,107,114,117,120,127,136,141,146,149	g+	0.9744292762202909	0.9744292762202909	0.0	0.977194361135842	0.9665681014441916	0.9795253660808387	0.0	0.0	0.0	0.0	0.0	0.0	0.3157894736842105	0.4375	0.8444818066888492	65		S_1	22	22	-1
19	442	10,29,31,37,53,56,70,71,74,75,82,89,103,119,128,136,140,144,150,152,155,157,181,189,191,193/3,18,23,35,60,61,63,66,81,86,98,105,109,115,125,126,144	g+	0.974349860009332	0.974349860009332	0.0	0.9734492396606816	0.9713125381311377	0.9782878022361766	0.0	0.0	0.0	0.0	0.0	0.0	0.9444444444444444	0.5789473684210527	0.848114850179178	29		S_1	26	17	-1
20	928	1,11,19,25,56,60,62,66,67,70,71,72,76,82,84,92,94,107,110,115,118,128,130,133,148,151,175,196,197/1,9,13,20,29,35,39,45,54,62,71,73,76,77,85,92,97,102,105,110,112,114,118,120,126,130,131,134,136,139,141,143	e+	0.974137626259267	0.974137626259267	0.0	0.9749144923282795	0.9696482480164843	0.9778501384330376	0.0	0.0	0.0	0.0	0.0	0.0	0.5555555555555556	0.6666666666666666	0.8359041537448687	62		S_1	29	32	-1
